#######
#P....#
#.#.#.#
#.....#
#######