###############
#P..#....#....#
##.#.##.###.#.#
#..#..#.......#
#.##.####.###.#
#....#........#
#.####.######.#
#............##
###############