##########
#P..#....#
###.#.##.#
#....#...#
#.####.#.#
#........#
##########