###############
#P.....#......#
#.##..###..##.#
#......#......#
#.####...####.#
#.............#
##.##.###.##.##
#.............#
##.##.###.##.##
#.............#
#.####...####.#
#......#......#
#.##..###..##.#
#......#......#
###############
