##############################
#..#..............#.........P#
#..#........#................#
#..#..########################
#..#.........................#
#........################....#
#............#...............#
########.....#........########
#............#####...........#
#.....########.......#.......#
#....................#.......#
#.....#################......#
#.....#......#........#......#
#............#....#..........#
#.....#......#....#######..###
##..###......#.........#.....#
#......................#.....#
#################......#.....#
#......................#.....#
#........#.............#.....#
#........###########.........#
#...######........#....#######
#........#........#..........#
#........##..###..#..........#
#######...........#######....#
#..........#.................#
#####..#############....######
#......#...........#....#....#
#............#............#..#
##############################