############################
#..........................#
#.####.#####.##.#####.####.#
#....#.#.....#....#......#.#
#.####.#####.##.#####.####.#
#..........................#
#.####.##.###..###.##.####.#
#....#.##.#......#.##.#....#
#.####.##.#.####.#.##.####.#
#......##.#.####...##......# 
######.##.#......#.##.######
######.##.########.##.######
######.##.########.##.######
#......##....P.....##......#
######.##.########.##.######
######.##.########.##.######
######.##.########.##.######
#............##............#
#.####.#####.##.#####.####.#
#.#..#.....#.##.....#.#..#.#
#.##.#.#####.##.#####.#..#.#
#....#................##...#
###....#.########.#....###.#
#......#..........#......#.#
#.##########..##########.#.#
#..........................#
############################
